fr	en	fr_sen	en_sen
de	prep.of	Deux litres de bière.	Two litres of beer.
je	pro.I	Je suis content.	I am happy.
pas	adv.not	Je ne sais pas.	I do not know.
le	art.the	C'est le weekend.	It's the weekend.
que	conj.that	Je sais que tu es là.	I know that you are there.
la	art.the	La télévision est grande.	The television is big.
tu	pro.you	Tu es content?	You are happy?
vous	pro.you (formal)	Vous êtes charmant.	You are charming.
un	art.a, an	Je veux un hamburger.	I want a hamburger.
et	conj.and	Les oranges et les bananes sont là.	The oranges and the bananas are there.
à	prep.to	Je vais à Paris.	I am going to Paris.
il	pro.he	Il est cool.	He is cool.
ne	ne and pas are used together to negate verbs	Je ne suis pas rich.	I am not rich.
les	art.the (plural)	Les fruits sont verts !	The fruit are green!
en	prep.in	Je travaille en France.	I work in France.
on	pro.we	On regarde la télévision.	We watch TV.
ça	pro.that	Ça va ?	How are you? (literally: That goes?)
ce	you?pro.	Est-ce vous ?	Is this 
pour	prep.for	J'ai un cadeau pour toi.	I have a present for you.
qui	conj pro.which	C'est qui ?	Who is it?
mais	conj.but	Je suis rich mais je ne suis pas content.	I am rich but I am not happy.
dans	prep.in	Il est dans le château.	He is in the castle.
nous	pro.we	Nous sommes raisonable.	We are reasonable.
elle	pro.she	Elle est américaine.	She is American.
bien	adv.well	Tu danses bien.	You dance well.
me	pro.myself	Je me vois dans le mirroir.	I see myself in the mirror.
si	adv conj.if	Je ne sais pas si il est là.	I do not know if he is there.
y	there	Paris ? Il y va.	Paris? He is going there. (Literally: He there goes.)
non	adv.no	Est-ce un non ?	Is it a no?
avec	prep.with	Je suis avec vous.	I am with you.
tout	adv pro.all	Il est tout à vous.	It is all yours.
plus	adv.more	Je veux plus.	I want more.
mon	det pro.my	C'est mon problème.	It's my problem.
te	pro.you	Je t'aime. 	I love you.(Note: te aime is contracted into t'aime)
moi	pro.me	Est-ce pour moi ?	Is it for me?
oui	part.yes	Oui, c'est moi.	Yes, it's me.
faire	v.to do	Je veux faire quelque chose.	I want to do something.
ils	pro.they (masculine)	Ils sont grands !	They are tall!
sur	prep.on	Elle est sur la table.	She is on the table.
quoi	pro.what	Ça fait quoi ?	What does it do?
se	pro.to himself	Il se brosse les dents.	He brushes his teeth. (literally: he to himself brushes the teeth)
comme	conj.like	C'est comme ça.	It's like that.
être	v.to be	Je veux être libre.	I want to be free.
ici	adv.here	Elle est ici.	She is here.
lui	pro.him	Elle est tout pour lui.	She is everything to him.
votre	det pro.your	C'est votre destin.	It's your destiny.
pourquoi	adv.why	Sais-tu pourquoi ?	Do you know why?
où	adv.where	Je sais où elle est.	I know where she is.
rien	pro.nothing	Je comprend rien.	I understand nothing.
là	adv.there	Je sais que tu es là.	I know you are there.
quand	adv conj.when	C'est quand, la soirée ?	It's when, the party?
dire	v.to say	Il m'a dit un truc.	He told me something.
son	det pro.his	C'est son ami.	It's his friend.
ton	det pro.your	Je suis ton frère.	I am your brother.
alors	adv.So then	Alors, ton nouveau voisin, il est comment ?	So then, your new neighbor, what is he like?
comment	adv.how	Je sais comment le faire.	I know how to do it.
par	prep.by	Par chance, je suis là.	By luck, I'm here.
ou	conj.or	As-tu dit oui ou non?	Did you say yes or no?
chose	n.thing	La meilleure chose à faire est d'appeler votre mère.	The best thing to do is to call your mother.
bon	adj.good	Le joueur de golf a un bon swing.	The golfer has a good swing.
merci	int.thanks!	J'ai bien aimé le cadeau. Merci beaucoup !	I really liked the present. Thanks a lot!
juste	adj adv.fair	Ça va être juste.	It will be fair.
très	adv.very	Très bien.	Very good.
jamais	never	It's now or never.adv.	C'est maintenant ou jamais.
avoir	v.to have	Je sais ce que vous avez fait.	I know what you have done.
vraiment	adv.really	Tu es vraiment bon.	You are really good.
aussi	adv conj.also	J'ai un frère et une sœur aussi.	I also have a brother and a sister.
voir	v.to see	Je peux te voir à 2:30.	I can see you at 2:30.
même	adj adv.same	C'est la même chose.	It's the same thing.
maintenant	adv.now	Je suis prêt maintenant.	I'm ready now.
deux	num.two	J'ai deux chats.	I have two cats.
autre	adj.other	J'aime l'autre couleur.	I like the other color.
peu	adj adv n.little	J'ai peu d'argent.	I have little money.
quelque	adj.some	He has some books to read.	Il a quelques livres à lire.
temps	n.time	Je le fais tout le temps!	I do it all the time!
toujours	adv.always	Je le fais toujours.	I always do it.
encore	adv.still	Il est encore ici.	He is still here.
notre	det pro.our	On a notre suspect.	We have our suspect.
besoin	n.need	Je vais avoir besoin de toi.	I'm going to need you.
falloir	v.to be necessary	Il faut manger maintenant.	It is necessary to eat now.
vie	n.life	La vie est comme ça.	Life is like that.
aller	v.to go	Tu dois y aller.	You have to go.
fois	n.time (instance or occurrence of something)	Il est arrivé en retard plusieurs fois.	He has arrived late several times.
sans	prep.without	Je bois toujours mon thé sans sucre.	I always drink my tea without sugar.
donc	conj.therefore	Ma sœur sait coudre, donc elle fait ses propres vêtements.	My sister can sew, therefore she makes her own clothes.
monde	n.world	Je le veux plus que tout au monde.	I want it more than anything in the world.
avant	adv prep.before	Le joueur était nerveux avant son premier match.	The player was nervous before his first match.
sûr	adj.sure	Êtes-vous sûr que tout va bien?	Are you sure everything is fine?
trop	adv.too /too much	La robe est trop petite.	The dress is too small.
parler	v.to talk	Je dois te parler de quelque chose.	I need to talk to you about something.
père	n.father	Tu es mon père.	You are my father.
après	adv prep.after	Et après ?	And after?
dieu	n.God	Je crois en Dieu.	I believe in God.
homme	n.man	Tu es un homme bon.	You are a good man.
femme	n.woman	Je pense que Dieu est une femme.	I think God is a woman.
leur	det pro.them	Je ne leur ai pas dit.	I did not tell them.
vrai	adj adv.true	Et ça a longtemps été vrai.	And that's been true for a long time.
mal	adj n.bad	C’est mal de dire ça.	It's bad to say that.
chez	prep.at the home of	On est chez nous.	We are at home.
depuis	adv prep.since	Je n'ai pas fumé depuis 2005.	I have not smoked since 2005.
déjà	adv.already	Tu as déjà fait ça.	You have already done that.
beaucoup	adv.a lot	Je bois beaucoup.	I drink a lot.
mieux	adv.better	Tu peux faire mieux que ça.	You can do better than that.
mère	n.mother	Je veux voir ta mère.	I want to see your mother.
fille	n.daughter	C'est juste une petite fille.	It's just a little girl.
gens	n.people	Qui sont ces gens?	Who are these people?
quel	adj pro.what	Quel film veux-tu voir ?	What movie do you want to see?
désolé	adj.sorry	Désolé pour ça.	Sorry for that.
voilà	int.there it is	Voilà, c'est exact.	There it is, that's right.
petit	adj.small	Le monde est petit.	The world is small.
maison	n.house	Je suis dans la maison.	I am in the house.
soir	n.evening	Elle sera là ce soir.	She will be there this evening.
cela	pro.that	J’ai pensé à cela hier.	I thought of that yesterday.
passé	adj n.past (opposite of future)	Nous avons fait quelque chose comme cela dans le passé.	We have done something like this in the past.
jour	n.day	Je vais vous en parler un jour.	I'll tell you about it one day.
prendre	v.to take	Tu peux prendre ce que tu veux.	You can take whatever you want.
monsieur	n.sir	Excusez-moi, monsieur.	Excuse me, sir.
savoir	v.to know	Je veux savoir ce que je peux faire.	I want to know what I can do.
argent	n.money	Où est votre argent?	Where's your money?
nom	n.name	Quel est votre nom?	What is your name?
nuit	n.night	Je peux le faire toute la nuit.	I can do it all night.
bonjour	int.hello	Bonjour!	Hello!
raison	n.reason	Il a raison.	He is right.
moins	adv.less	C'est moins cher.	It's less expensive.
maman	n.mom	Maman a toujours raison.	Mom is always right.
reste	n.remainder	J'ai passé le reste de la semaine à la plage.	I spent the remainder of the week at the beach.
seul	adj.only	Je suis son seul héritier.	I am his only heir.
aider	v.to help	Je suis là pour vous aider.	I am here to help you.
papa	n.dad	Papa est à la maison.	Dad is at home.
entre	prep.between	Que cela reste entre nous!	Let it stay between us!
gars	n.guy / guys	Je connais un gars qui travaille dans un restaurant.	I know a guy who works in a restaurant.
fils	n.son	Tu es toujours mon fils.	You are still my son.
trois	num.three	Où sont les trois autres?	Where are the other three?
assez	adv.enough	Vous en avez eu assez.	You have had enough.
famille	n.family	Je veux une famille.	I want a family.
trouver	v.to find	J'ai trouvé mes clés.	I found my keys.
travail	n.job	Je lui ai trouvé un travail.	I found him a job.
tête	n.head	Tout ça est dans ta tête.	This is all in your head.
voiture	n.car	Je suis dans la voiture.	I am in the car.
vite	adv.quickly	Marche vite !	Walk quickly!
partir	v.to leave	Il est temps de partir.	It is time to leave.
chance	n.luck	J'ai de la chance.	I'm lucky (literally: I have some luck)
pendant	prep.during	Pendant une semaine	During one week
idée	n.idea	Quelle idée !	What an idea!
part	n.share	Vous avez fait votre part.	You have done your part.
demain	adv.tomorrow	Je vais le voir demain.	I will see him tomorrow.
grand	adj.large	C'est un grand pays.	It's a large country.
ami	n.friend	Je suis ici avec un ami.	I am here with a friend.
venir	v.to come	Je lui ai dit de venir nous voir.	I told him to come see us.
tard	adv.late	Désolé de venir si tard.	Sorry to come so late.
passer	v.to pass	Il veut passer du temps avec son fils.	He wants to spend time with his son.
truc	n.thing	Où est le truc ?	Where's the thing?
tant	adv.so much	J'ai tant de chose à faire.	I have so much to do.
sens	n.meaning	Il a trouvé le sens du mot dans le dictionnaire.	He found the meaning of the word in the dictionary.
puis	adv.then	J'ai mangé trois gâteaux, puis j'en ai mangé un de plus !	I ate three cakes, then I ate another!
porte	n.door	Il y a un homme à la porte.	There is a man at the door.
sortir	v.to exit	Je suis sorti par la porte arrière.	I exited by the back door.
heure	n.hour	Tu as une heure.	You have an hour.
contre	prep.against	Êtes-vous pour ou contre son idée ?	Are you for or against his idea?
coup	n.hit	Le combattant a bloqué le coup avec son bras.	The fighter blocked the hit with his arm.
ensemble	adv.together	Ils sont toujours ensemble.	They are still together.
nouveau	adj.new	Tout est nouveau.	Everything is new.
amour	n.love	Je veux ton amour.	I want your love.
sous	under	Il se trouve sous votre	It can be found under your seat.
cas	n.case	Est-ce le cas ?	Is that the case?
rester	v.to stay	Restez chez vous si vous êtes malade.	Stay home if you are sick.
histoire	n.story	Quelle histoire !	What a story!
chercher	v.to search for	J'ai cherché partout, mais je n'ai pas retrouvé mes clés.	I searched everywhere, but I could not find my keys.
seulement	adv.only	Je veux seulement vous aider.	I only want to help you.
genre	n.type	Quel genre de voiture as-tu?	What kind of car do you have?
mois	n.month	Il vient ici une fois par mois.	He comes here once a month.
frère	n.brother	Il est plus grand que son frère.	He is taller than his brother.
laisser	v.to let	Ma mère m'a laissé sortir ce soir.	My mother let me go out tonight.
car	conj.because	Je suis le meilleur candidat car je sais ce qu'il faut faire.	I am the best candidate, because I know what needs to be done.
mettre	v.to place	Le garçon a mis un beau vase sur la table.	The boy placed a beautiful vase on the table.
aucun	adj.none	Aucune des tribus ne parle la même langue.	None of the tribes speak the same tongue.
ville	n.town	Nous sommes en ville.	We are in town.
chaque	adj.every	Je viens ici chaque jour.	I come here every day.
bébé	n.baby	Mon petit-fils est encore un bébé.	My grandson is still a baby.
longtemps	adv.for a long time	Le couple avait été ensemble depuis longtemps avant de se marier.	The couple had been together a long time before marrying.
ni	adv conj.nor	Je n'aime ni les pommes ni les raisins.	I like neither apples nor grapes.
voici	prep.here it is	Voici un résumé de la réunion de la semaine dernière.	Here is a summary of last week's meeting.
donner	v.to give	Je vais te donner une chance de plus.	I'll give you one more chance.
type	n.dude	Son frère est un type sympathique.	His brother is a nice dude.
corps	n.body	Le corps a des défenses naturelles contre les virus.	The body has natural defences against viruses.
endroit	n.place	Je suis dans un endroit calme.	I am in a calm place.
façon	n.way	Laisse-moi le faire à ma façon.	Let me do it my way.
dont	pro.of which	Le noir est la seule chose dont j'ai peur.	The dark is the only thing of which I'm afraid.
premier	adj.first	Elle est mon premier amour.	She is my first love.
main	n.hand	Je peux le faire avec une main.	I can do it with one hand.
côté	n.side	Les deux côtés de la feuille de papier sont blancs.	Both sides of the sheet of paper are blank.
pouvoir	v.to be able to do something	Tu peux finir ce projet.	You can finish this project.
vieux	adj.old	Le vieux château a été construit sur une colline.	The old castle was built on a hill.
matin	n.morning	Elle était là ce matin.	She was there this morning.
tellement	adv.so much	Il y a tellement de choses que je veux te dire.	There are so many things I want to tell you.
enfant	n.child	Vous êtes une enfant.	You are a child.
pardon	int.excuse me!	Pardon ? Je n'ai pas entendu la question.	Sorry? I did not hear the question.
devant	prep.in front of	Regarde devant toi.	Look in front of you.
devoir	aux v.to have to	Elle doit étudier pour réussir ses examens.	She has to study to pass her exams.
vers	prep.towards	L'avion a entamé sa descente vers l'aéroport.	The plane began its descent towards the airport.
chambre	n.bedroom	Mon père est dans sa chambre.	My father is in his room.
droit	adj n.right	Tu as le droit de savoir.	You have the right to know.
mari	n.husband	Il sera un très bon mari pour elle.	He will be a very good husband for her.
enfin	adv.finally	Il a enfin décidé d'arrêter de fumer.	He finally decided to stop smoking.
eau	n.water	Mon ami avait soif et a demandé un verre d'eau.	My friend was thirsty and asked for a glass of water.
nouvelle	n.(piece of) news	Nous avons une bonne nouvelle.	We have good news.
boulot	n.job	Ils ont fait du bon boulot.	They did a good job.
arrêter	v.to stop	Les freins servent à arrêter un véhicule en mouvement.	Brakes are used to stop a moving vehicle.
terre	n.earth	La Chine est le pays le plus peuplé de la terre.	China is the most populous country on earth.
loin	adv.far	Il est loin de chez lui.	He is far from home.
fin	adj n.end	À la fin, elle a eu une bonne idée.	In the end, she had a good idea.
croire	v.to believe (in something)	Je sais que tu me crois.	I know you believe me.
gros	adj.large	Un gros corbeau noir est perché sur la branche.	A large black crow is perched on the branch.
plutôt	adv.instead	Je pourrais prendre le bus, mais je vais plutôt marcher.	I could take the bus, but I will walk instead.
jouer	v.to play	J'aime jouer au golf pour me détendre.	I enjoy playing golf to relax.
bureau	n.office	Viens à mon bureau.	Come to my office.
hier	adv.yesterday	Nous avons fait ça hier.	We did this yesterday.
prêt	adj.ready	Il vous faut être prêt à tout.	You have to be ready for anything.
celui	this one / that one	J’ai acheté deux cafés celui-ci est décaféiné.	I bought two coffees this one is decaffeinated.
demander	v.to request something	Le juge a demandé au témoin de parler.	The judge asked the witness to speak.
jeune	adj n.young	Ta mère est très jeune.	Your mother is very young.
dehors	adv n.outside	Ils sont dehors.	They are outside.
école	n.school	J'enseigne l'anglais dans une petite école.	I teach English in a small school.
beau	adj.beautiful	Tu as un nom si beau.	You have such a beautiful name.
appeler	v.to call	Appelez la police.	Call the police.
semaine	n.week	Tu as eu une semaine pour faire ça.	You had a week to do this.
vérité	n.truth	En vérité, vous avez raison.	In truth, you are right.
chef	n.leader	Vous êtes le chef.	You are the leader.
confiance	n.trust	On peut me faire confiance.	You can trust me.
feu	n.fire	Votre voiture est en feu.	Your car is on fire.
vivre	v.to live	Je vis dans une grande ville.	I live in a big city.
journée	n.day	Je peux le faire toute la journée.	I can do it all day.
près	adv.close	Reste près.	Stay close.
meilleur	adj n.best	Tu es le meilleur pour ce travail.	You are the best for this job.
dessus	adv.on / above	Voici la table - mettez la valise dessus.	There's the table - put the suitcase on it.
dur	adj.hard	Ça doit être dur à faire.	It must be hard to do.
manger	v.to eat	Allons prendre quelque chose à manger !	Let's have something to eat!
garçon	n.boy	Tu es un bon garçon.	You are a good boy.
équipe	n.team	Voilà mon équipe.	Here is my team.
arriver	v.to arrive	Je suis sûr que nous arriverons à l'heure.	I am sure we will arrive on time.
guerre	n.war	Je suis contre la guerre.	I am against war.
derrière	adv prep.behind	Il est juste derrière toi.	He's right behind you.
plein	adj.full	Le ballon flotte parce qu'il est plein d'hélium.	The balloon floats because it is full of helium.
fort	adj.strong	Vous êtes très fort.	You are very strong.
exactement	adv.exactly	Je sais exactement ce que je vais faire.	I know exactly what I'm going to do.
presque	adv.almost	Mon travail est presque fini.	My work is almost finished.
dernier	adj n.last	Le dernier est le meilleur.	The last one is the best.
fou	adj n.crazy	Il est fou.	He is crazy.
fête	n.party	Tu dois aller à la fête.	You have to go to the party.
tomber	fall	Laisse la pluie tomber	Let the rain fall on us.
attendre	v.to wait for	j'ai dû attendre mon ami.	I had to wait for my friend.
jeu	n.game	Le jeu est simple et facile à apprendre.	The game is simple and easy to learn.
génial	adj.great	Il est génial.	He is great.
envie	n.desire	Ma plus grande envie serait de voyager en Australie.	My greatest desire would be to travel to Australia.
pays	n.country	Quel pays !	What a country!
cours	n.class (school)	Je veux vous parler après le cours.	I want to talk to you after class.
numéro	n.number	Prends un numéro !	Take a number!
bientôt	adv.soon	Il sera bientôt là.	He will be here soon.
cinq	num.five	Je la connais depuis cinq ans.	I have known her for five years.
parfait	adj.perfect	Cet endroit est parfait.	This place is perfect.
ainsi	adv.so	Il doit en être ainsi.	It must be so.
autant	adv.as much as	Je bois autant d’eau que jamais.	I drink as much water as ever.
retour	n.return	Est-ce la raison de ton retour ?	Is this the reason for your return?
peine	sadness	de la peine pour faire se donner	pain to give oneself
mauvais	adj.bad	Ne sois pas un mauvais garçon.	Don't be a bad boy.
penser	v.to think	Il vous faut penser à votre famille.	You have to think about your family.
mot	n.word	Il veut toujours avoir le dernier mot.	He always wants to have the last word.
quatre	num.four	Nous sommes une famille de quatre.	We are a family of four.
essayer	v.to try	Essaie de te mettre à la place de ta mère.	Try to put yourself in your mother's place.
rentrer	to return	Rentrez dans la maison	Go back into the house.v.
travailler	v.to work	Je travaille dans un cabinet d'avocats.	I work in a law office.
regarder	v.to watch	Je voulais juste te regarder.	I just wanted to watch you.
parfois	adv.sometimes	Ça arrive parfois.	It happens sometimes.
faute	n.mistake	Le texte était plein de fautes d'orthographe.	The text was full of spelling mistakes.
choix	n.choice	Faites un autre choix.	Make another choice.
bas	adj n.low	Le soir, le soleil est bas.	In the evening, the sun is low.
heureux	adj.happy	Je suis très heureux de te revoir.	I am very happy to see you again.
facile	adj.easy	Ça va être facile.	It will be easy.
entendre	v.to hear	Je veux vous entendre le dire.	I want to hear you say it.
lit	n.bed	Il doit rester au lit.	He must stay in bed.
entrer	v.to enter	Il est entré et a immédiatement demandé un verre d'eau.	He came in and immediately asked for a glass of water.
plaisir	n.pleasure	Quel plaisir !	What a pleasure!
ensuite	adv.next	Que devrais-je faire ensuite?	What should I do next?
propre	adj.own	Chaque pays a sa propre culture.	Each country has its own culture.
route	n.way	Il est en route.	He is on his way.
tour	n.stroll	Je suis allé faire un tour dans le parc.	I went for a stroll in the park.
garder	v.to keep	Je vais le garder avec moi.	I will keep it with me.
année	n.year	Il y a douze mois et 365 jours dans une année.	There are twelve months and 365 days in a year.
drôle	adj.funny	Tu es très drôle.	You are very funny.
rendre	v.to give back	Je lui ai rendu les clés.	I gave back his keys.
lieu	n.place	Vous êtes en lieu sûr.	You are in a safe place.
sujet	n.subject	Je connais bien le sujet.	I know the subject well.
difficile	adj.difficult	Cela doit être si difficile pour vous.	It must be so difficult for you.
pire	adj n.worse	Mes résultats scolaires sont pires.	My school results are worse.
sorte	n.type	Dans certaines cultures, un baiser est une sorte de salutation.	In some cultures, a kiss is a type of greeting.
ceci	pro.this	Ceci est pour mon ami.	This is for my friend.
état	n.state (condition of something)	La table est vieille mais elle est en bon état.	The table is old but it is in good condition.
chien	n.dog	Ce chien est à moi.	This dog is mine.
perdre	v.to lose	Ma fille vient de perdre sa première dent.	My daughter just lost her first tooth.
tôt	adv.early	Désolé de vous appeler si tôt.	Sorry to call you so soon.
dès	from / of the	Dès que j’arrive à la maison, je me fais couler un bain.	As soon as I get home, I run myself a bath.
café	n.coffee	Merci pour le café.	Thank you for the coffee.
verre	n.glass (transparent substance)	Elle a versé du lait dans le verre.	She poured milk into the glass.
ferme	adj n.farm	Je travaille dans une ferme.	I work on a farm.
d'accord	int.okay	D'accord ! Je viendrai à la fête demain.	OK! I will come to the party tomorrow.
sûrement	adv.surely	Mon professeur connaît sûrement la réponse.	My teacher surely knows the answer.
montrer	v.to show	Je vais te montrer la ville.	I'll show you the city.
cœur	n.heart	Je le connais par cœur.	I know it by heart.
avis	n.opinion	À mon avis, il a raison.	In my opinion, he is right.
sauf	adj prep.except	Personne ne peut le faire sauf toi.	No one can do it except you.
doute	n.doubt	Ils sont heureux, sans aucun doute.	They are happy, without a doubt.
seconde	n.second	Donne-moi une seconde !	Give me a second!
sérieux	adj.serious	Maintenant je suis sérieux.	Now I am serious.
gentil	adj.kind	Mon père est très gentil.	My father is very kind.
haut	adj n.top	Ma maison est en haut de la route.	My house is at the top of the road.
malade	yesterday.adj n.	Mon fils était malade hier.	My son was sick 
esprit	n.mind	Il a un esprit génial !	He has an amazing mind!
moyen	n.way	Donne-moi un autre moyen.	Give me another way.
six	num.six	Il est déjà six heures.	It is already six o'clock.
salle	n.room	Tous les sièges de la salle étaient occupés.	All the seats in the room were occupied.
comprendre	v.to understand	Des instructions simples sont faciles à comprendre.	Straightforward instructions are easy to understand.
sauver	v.to save	Je suis venu ici pour te sauver.	I came here to save you.
bras	n.arm	Regarde mon bras.	Look at my arm.
chéri	adj n.darling	Chérie, je suis de retour.	Darling, I'm back.
partout	adv.everywhere	Nos gens sont partout.	Our people are everywhere.
visage	n.face	Je connais ton visage.	I know your face.
chemin	n.way	Allons par ce chemin.	Let's go this way.
soirée	n.evening	Nous avons passé une soirée sympa au restaurant.	We spent a nice evening at the restaurant.
livre	n.book	Je lui ai donné un livre.	I gave him a book.
boire	v.to drink	Je veux quelque chose à boire.	I want something to drink.
surtout	adv.above all	L'équipe doit surtout rester unie.	The team must, above all, stay united.
bois	n.wood	Ma maison est en bois.	My house is made of wood.
rapport	n.report	Je veux vous parler à propos de ce rapport.	I want to speak to you about this report.
pauvre	adj.poor	Je fais du bénévolat pour aider les familles pauvres.	I do volunteer work to help poor families.
sinon	you can't go out tonight.conj.	Fais-le, sinon tu ne peux pas sortir ce soir.	Do it, otherwise 
rencontrer	v.to meet	Il a voulu te rencontrer.	He wanted to meet you.
an	n.year	Je suis là depuis un an.	I have been there for a year.
devenir	v.to become	Le garçon veut devenir pompier.	The boy wants to become a firefighter.
souvent	adv.often	Je ne viens pas souvent ici.	I don't come here often.
revenir	v.to come back	Il est revenu à la maison après des années à l'étranger.	He returned home after years abroad.
pièce	n.room (of a house, etc)	Ils sont tous deux dans la pièce.	They are both in the room.
dormir	v.to sleep	Je me sens bien car j'ai bien dormi.	I feel good because I slept well.
grave	adj.serious	La situation est grave.	The situation is serious.
commencer	v.to start	Ne commence pas à faire ça.	Don't start doing this.
roi	n.king	À bas le roi !	Down with the king!
carte	n.map	Le professeur a montré le pays sur la carte.	The teacher pointed the country out on the map.
paraître	v.seem to	La tâche paraissait insurmontable mais j'ai persévéré.	The task seemed insurmountable but I kept trying.
rêve	n.dream	Ça doit être un rêve.	It must be a dream.
bonsoir	int.good evening	Bonsoir ! Nous avons une réservation pour deux.	Good evening! We have a reservation for two.
faux	adj.false	La police a signalé que le passeport était un faux.	The police reported that the passport was a fake.
peur	fear	J'ai peur de faire une erreur.	I'm afraid of making a mistake.
sac	n.bag	Il me faut un sac.	I need a bag.
content	adj.happy	Je suis content de te voir ici.	I'm glad to see you here.
cher	adj.expensive	Ma mère a acheté une bague très chère.	My mother bought a very expensive ring.
acheter	v.to buy	Je veux en acheter un autre.	I want to buy another one.
début	n.beginning	Ça serait un bon début.	It would be a good beginning.
maître	n.master	Vous êtes le maître.	You are the master.
patron	n.boss	Tu es mon patron.	You are my boss.
noël	n.christmas	Noël arrive bientôt.	Christmas is coming soon.
rue	n.street	Ne joue pas dans la rue.	Don't play on the street.
prix	n.price	Ne pense pas au prix.	Don't think about the price.
gagner	win	Pensez-vous que nous avons une chance de gagner? 	Do you think we have a chance to win?
effet	n.effect	Ce médicament a plusieurs effets secondaires.	This medication has several side effects.
tirer	v.to pull	Il faut tirer la porte pour l'ouvrir.	You have to pull the door in order to open it.
avocat	n.lawyer	Je veux parler à un avocat.	I want to speak to a lawyer.
voix	n.voice	Sa voix est très belle.	Her voice is very beautiful.
noir	adj.black	La photo a été imprimée en noir et blanc.	The picture was printed in black and white.
apprendre	v.to learn	Je suis venu ici pour apprendre.	I came here to learn.
dix	num.ten	Le film commence à dix heures.	The film starts at ten.
probablement	adv.probably	Tu savais probablement déjà ça.	You probably already knew that.
bout	n.end	La salle de bain est au bout du couloir.	The bathroom is at the end of the hallway.
ordre	n.order	Mets ta chambre en ordre.	Put your room in order.
incroyable	adj.incredible	Tu es vraiment incroyable.	You are truly incredible.
retrouver	v.to find	Il a enfin retrouvé ses clés perdues.	He finally found his lost keys.
bienvenue	int.welcome!	Bienvenue ! Bon séjour parmi nous !	Welcome! Enjoy your stay with us!
force	n.strength	Il a plus de force que moi.	He has more strength than I do.
ailleurs	adv.elsewhere	Regardez ailleurs.	Look elsewhere.
protéger	v.to protect	On va te protéger.	We will protect you.
utiliser	v.to use	Je sais comment utiliser ça.	I know how to use this.
sœur	n.sister	Ta sœur est toujours aussi belle.	Your sister is still so beautiful.
complètement	adv.completely	Il est complètement fou.	He is completely crazy.
dos	n.(anatomy) back of a person	La gymnaste a levé les bras et arqué le dos.	The gymnast lifted her arms and arched her back.
sale	adj.dirty	Ma voiture est sale.	My car is dirty.
anniversaire	n.birthday	Demain est mon anniversaire.	Tomorrow is my birthday.
oncle	n.uncle	Mon oncle a trois enfants.	My uncle has three children.
paix	n.peace	Ils veulent la paix.	They want peace.
battre	v.to beat	Le coureur a battu facilement tous ses adversaires.	The runner easily beat all his opponents.
absolument	adv.absolutely	Je veux absolument tout savoir.	I absolutely want to know everything.
finir	v.to finish	En tout cas, je dois finir ce travail pour demain.	In any case, I must finish this work for tomorrow.
libre	adj.free	Je suis un homme libre.	I am a free man.
avion	n.airplane	L'avion vole au-dessus de l'océan.	The plane is flying over the ocean.
rouge	adj.red	Ma nouvelle voiture est rouge.	My new car is red.
retourner	v.to return	Il est retourné chez lui après des années à l'étranger.	He returned home after years abroad.
bateau	n.boat	Mon bateau est petit.	My boat is small.
sympa	adj.nice	Ta maison est très sympa.	Your house is very nice.
médecin	n.doctor	Je veux un médecin.	I want a doctor.
balle	n.bullet	Beaucoup de revolvers peuvent contenir six balles.	Many revolvers can hold six bullets.
faim	n.hunger	J'ai faim.	I'm hungry.
fond	n.bottom	La corde a atteint le fond du puits.	The rope reached the bottom of the well.
habitude	n.habit	Je ne veux pas retomber dans mes anciennes habitudes.	I do not want to revert to my old habits.
porter	v.to carry	Nous avons le droit de porter des armes.	We have the right to carry weapons.
autour	adv.around	Regardez autour de toi.	Look around you.
colère	n.anger	Il a soudainement déchaîné sa colère.	He suddenly unleashed his anger.
or	n.gold	Les métaux précieux, tels que l'or, sont chers.	Precious metals, such as gold, are expensive.
ligne	n.line	Il est sur une autre ligne.	It is on another line.
magnifique	adj.magnificent	Ç'est magnifique.	It's magnificent.
gauche	adj n.left	Votre chambre est la première à gauche.	Your room is the first on the left.
clair	adj.clear	Tout est clair pour moi maintenant.	Everything is clear to me now.
neuf	adj num.new	Il est tout neuf.	It is brand new.
cadeau	n.gift	Je veux te donner un cadeau.	I want to give you a gift.
hors	except	Hors de ma vue	Outside of my view.
dedans	adv prep.in	Il doit y avoir quelque chose là-dedans.	There must be something in there.
pote	n.friend	Je connais mon pote depuis plusieurs années.	I have known my friend for several years.
expliquer	v.to explain	Elle ne va pas le leur expliquer.	She will not explain it to them.
espèce	species / kind	Elle portait une espèce de cape en velours.	She was wearing a type of velvet cloak.
montre	n.watch	Je vais vous acheter une montre.	I'll buy you a watch.
pied	n.foot	Je vais toujours à pied.	I always go on foot.
plusieurs	adj.several	Il est venu plusieurs fois.	He came several times.
marcher	v.to walk	Tu dois me faire marcher.	You have to make me walk.
lumière	n.light	Je peux voir la lumière.	I can see the light.
réponse	n.answer	Votre réponse est au point.	Your answer is ready.
coin	n.corner (of the street, etc.)	Il y a un bureau dans un coin de la pièce.	There is a desk in the corner of the room.
suivre	v.to follow	Mon chien me suit partout.	My dog follows me everywhere.
moitié	n.half	Donne-moi la moitié.	Give me half.
pareil	adj.similar	Ces deux maisons ne sont pas pareilles.	These two houses aren't the same.
joli	adj.pretty	Tu es très jolie.	You are very pretty.
vouloir	v.to want	Ne voulez-vous pas savoir qui est cet homme ?	Don't you want to know who this man is?
envoyer	v.to send	Je veux envoyer une lettre à ma mère.	I want to send my mother a letter.
soleil	n.sun	Le soleil est très important pour la vie.	The sun is very important for life.
selon	prep.according to	Selon le journal, la grève est terminée.	According to the newspaper, the strike is over.
arrière	adj n.back	Je pensais vous avoir dit de rester en arrière.	I thought I told you to stay back.
lire	v.to read	Je veux quelque chose à lire.	I want something to read.
doucement	adv.softly	Parle doucement.	Speak softly.
tenir	v.to hold	J'ai tenu la main de mon fils pour traverser la route.	I held my son's hand to cross the road.
sortie	n.exit	La sortie sera sur la gauche.	The exit will be on the left.
poser	v.to put	J'ai posé mon verre sur la table de la cuisine.	I put my glass on the kitchen table.
chaud	adj.hot	Le café est très chaud.	The coffee is very hot.
connaître	v.to know	Je connais un bon restaurant à proximité.	I know a good restaurant nearby.
loi	n.law	Tu connais la loi.	You know the law.
gamin	n.kid	Je ne suis pas un gamin.	I am not a kid.
professeur	n.teacher	Je suis professeur.	I am a teacher.
froid	adj n.cold	Il veut boire quelque chose de froid.	He wants to drink something cold.
but	n.goal	Nous avons le même but.	We have the same goal.
debout	adv int.standing	Il est toujours debout.	He is still standing.
boîte	n.box	Je peux mettre des choses dans une boîte.	I can put things in a box.
ciel	n.sky	Le soleil est dans le ciel.	The sun is in the sky.
enquête	n.investigation	Notre enquête est en cours.	Our investigation is ongoing.
télé	abbr.tv	Il regarde parfois la télé.	He sometimes watches TV.
oublier	v.to forget	Essaie de ne rien oublier.	Try not to forget anything.
poste	n.station	Je dois me rendre au poste de police.	I have to go to the police station.
triste	adj.sad	Je suis triste quand il pleut.	I am sad when it rains.
aimer	v.to love	Je vous aime plus que je ne peux dire.	I love you more than I can say.
preuve	n.proof	Je veux une preuve.	I want proof.
dame	n.lady	Je me demande qui était cette dame.	I wonder who this lady was.
écouter	v.to listen to	Les enfants écoutaient le professeur attentivement.	The children listened to the teacher attentively.
cuisine	n.kitchen	La cuisine est en bas.	The kitchen is downstairs.
sentir	v.to feel	Je voulais vous faire sentir comme chez vous.	I wanted to make you feel at home.
blanc	adj.white	Ce chien est blanc.	This dog is white.
chanson	n.song	Cette chanson est belle.	This song is beautiful.
gueule	n.mouth	Il a une grande gueule.	He has a big mouth.
santé	int n.health	Mon frère est en bonne santé.	My brother is in good health.
déjeuner	n v.lunch	Je dois prendre mon déjeuner.	I must have my lunch.
pourtant	yet / however	J'ai beaucoup mangé je n'avais pourtant pas très faim.	I ate a lot I was not very hungry, however.
ouvrir	v.to open	La nouvelle fenêtre est très dure à ouvrir.	The new window is very hard to open.
âme	n.soul	Que son âme repose en paix.	May his soul rest in peace.
voler	v.to fly	L'avion vole à l'altitude normale.	The plane is flying at the usual altitude.
chacun	pro.each	Chacun de nous devrait faire de son mieux.	Each of us should do our best.
clé	n.key	Voici la clé de ta chambre.	Here is the key to your room.
bord	n.side	J'ai garé ma voiture sur le bord de la route.	I parked my car at the side of the road.
vendre	v.to sell	Il a décidé de vendre sa voiture.	He decided to sell his car.
enfer	n.hell	C'était parfois l'enfer, mais j'ai finalement terminé le marathon.	It was hell at times, but eventually I finished the marathon.
diable	n.devil	Les gens disent que je suis le diable.	People say that I am the devil.
appartement	n.apartment	Voici la clé de mon appartement.	Here is the key to my apartment.
étrange	adj.strange	Quel homme étrange	What a strange man!
monter	v.to mount	Le moteur a assez de puissance pour monter la colline.	The engine has enough power to go up the hill.
bouche	n.mouth	Ouvre la bouche.	Open your mouth.
écrire	v.to write	Je vais écrire une lettre.	I will write a letter.
cheval	n.horse	Je veux monter à cheval.	I want to ride a horse.
honte	n.shame	Il n'y a pas de honte à demander de l'aide.	There is no shame in asking for help.
emmener	v.to take away	J'emmènerai mon frère à la ville.	I will take my brother to the city.
soin	n.care	Je prends soin de moi.	I take care of myself.
milieu	n.middle	Il y a une petite île au milieu du lac.	There is a small island in the middle of the lake.
prochain	adj n.next	Elle va avoir un bébé le mois prochain.	She is going to have a baby next month.
rire	n v.laughter	Le rire est bon pour la santé.	Laughter is good for your health.
voie	n.path	Je pense que nous sommes sur la bonne voie.	I think we are on the right path.
blague	n.joke	C'est une blague entre nous.	This is a joke between us.
trou	n.hole	Je dois creuser un trou afin de planter cette fleur.	I must dig a hole to plant this flower.
intérêt	n.interest	Je doute que ce soit de quelque intérêt pour vous.	I doubt that this is of any interest to you.
tel	adj.such	Ne sois pas un tel pauvre type !	Don't be such a poor guy!
réunion	n.meeting	Elle est en réunion.	She is in a meeting.
époque	n.time	Tu étais si jeune à cette époque.	You were so young at the time.
cacher	v.to hide	Je dois me cacher.	I have to hide.
peau	n.skin	Les serpents perdent régulièrement leur peau.	Snakes regularly shed their skin.
dingue	adj.crazy	C'est complètement dingue.	This is completely crazy.
robe	n.dress	C'est une jolie robe.	It is a pretty dress.
bière	n.beer	Avez-vous de la bière ?	Do you have beer?
lequel	pro.which	Lequel devrais-je utiliser ?	Which should I use?
don	n.gift (talent for something)	La musique est un don de Dieu.	Music is a gift from God.
journal	n.newspaper	Avez-vous fini de lire le journal?	Have you finished reading the newspaper?
sept	num.seven	Je serai de retour à sept heures.	I will be back at seven o'clock.
base	n.foundation	Le secteur minier est la base de notre économie.	The mining sector is the foundation of our economy.
vin	n.wine	Donne-moi le vin.	Give me the wine.
servir	v.to serve	Puis-je te servir un verre?	Can I serve you a drink?
jeter	v.to throw	Elle a jeté la balle dans le panier.	She threw the ball in the basket.
mer	n.sea	La fenêtre de ma chambre donne sur la mer.	My bedroom window overlooks the sea.
tort	n.fault	Le conducteur était en tort en passant au feu rouge.	The driver was at fault in passing the red light.
ouvert	adj.open	C'est ouvert.	It's open.
récupérer	v.to retrieve	Nous pouvons facilement récupérer les données stockées dans le système.	We can easily retrieve the data stored in the system.
nez	n.nose	Mon nez est gros.	My nose is big.
enceinte	adj.pregnant	Elle est enceinte.	She is pregnant.
secours	n.help	Le navire était en difficulté et a appelé au secours.	The ship was in distress and sent a signal for help.
entrée	n.entrance	Mon bureau est accessible depuis l'entrée principale.	My office is accessible via the main entrance.
fric	n.money	Je me fais du fric en achetant et en revendant des voitures.	I'm making money buying and reselling cars.
environ	adv.about	Je serai de retour dans environ une heure.	I will be back in about an hour.
répondre	v.to answer	Tu dois répondre à ces questions.	You must answer these questions.
départ	n.start	Il le savait depuis le départ.	He knew it from the start.
vérifier	v.to verify	Je peux vérifier par moi-même que c'est la vérité.	I can verify for myself that it is the truth.
lune	n.moon	Il a marché sur la lune.	He walked on the moon.
bruit	n.noise	Nous avons fait beaucoup de bruit.	We made a lot of noise.
intéressant	adj.interesting	C'est très intéressant.	It is very interesting.
lycée	n.high school	Je pense que tu devrais aller au lycée.	I think you should go to high school.
inutile	useless	Cela la rendrait totalement inutile	That would make it completely useless.
tas	n.pile	Le couple a pris des tas de photos pendant le voyage.	The couple took tons of pictures during the trip.
apparemment	apparently	Apparemment, ils ont survécu.	Apparently they survived.
bête	adj.beast	J'ai raconté une blague bête mais drôle.	I told a stupid but funny joke.
avenir	n.future	Les enfants sont notre avenir.	Children are our future.
thé	n.tea	Tu veux un peu de thé?	Do you want some tea?
bande	n.gang	La police a arrêté une bande de voleurs.	The police arrested a gang of thieves.
œil	n.eye	Garde un œil sur les filles.	Keep an eye on the girls.
plupart	n.majority	La plupart de l'électorat a voté oui.	A majority of the electorate voted yes.
procès	n.trial	L'avocat défendra la victime au procès.	The advocate will defend the victim during the trial.
sérieusement	adv.seriously	Il nous faut parler sérieusement.	We need to speak seriously.
pitié	pity / mercy	Parfois, j'ai pitié d'elle.	Sometimes I pity her
humain	adj n.human	La psyché humaine est très complexe.	The human psyche is very complex.
liberté	n.freedom	Je veux ma liberté.	I want my freedom.
anglais	adj n.english	Je ne parle pas anglais.	I do not speak English.
nourriture	n.food	La nourriture est sur la table.	Food is on the table.
nord	n.north	Ma maison est dans la partie nord de la ville.	My house is in the northern part of the city.
éviter	v.to avoid	C'est un homme paisible qui évite le conflit.	He is a peaceful man who avoids confrontation.
cour	n.yard	Il y a une cour derrière la maison.	There is a yard behind the house.
empêcher	v.to prevent	La barrière empêche les enfants de prendre les escaliers.	The barrier prevents children from using the stairs.
mur	n.wall	Mets-la sur le mur.	Put it on the wall.
conduire	v.to drive	La prochaine fois ce sera à moi de conduire.	Next time it will be up to me to drive.
tante	n.aunt	Elle ressemble à sa tante.	She looks like her aunt.
marier	v.to marry	Je veux me marier avec une fille comme elle.	I want to marry a girl like her.
vide	adj.empty	L'avion était presque vide.	The plane was almost empty.
sud	n.south	Ma maison est face au sud.	My house is facing south.
église	n.church	Une allée étroite mène à la vieille église.	A narrow pathway leads to the old church.
merveilleux	adj.wonderful	Ça a été merveilleux.	It was wonderful.
huit	num.eight	Mon frère a huit ans de plus que moi.	My brother is eight years older than me.
sol	n.ground	Regarde le sol.	Look at the ground.
niveau	n.level (degree of something)	Le premier niveau de ce jeu vidéo est très simple.	The first level of this video game is very easy.
fenêtre	n.window	Voulez-vous que je ferme la fenêtre ?	Do you want me to close the window?
magasin	n.store	Je suis allé au magasin.	I went to the store.
asseoir	v.to seat	L'hôte invita ses convives à s'asseoir à table.	The host invited his guests to sit at the table.
mignon	adj.cute	C'est très mignon.	It's very cute.
obtenir	v.to get	Mon frère connaît la procédure pour obtenir un visa.	My brother knows the procedure to obtain a visa.
reine	n.queen	Je vois une reine.	I see a queen.
espoir	n.hope	C'est son seul espoir.	It's his only hope.
glace	n.ice	L'eau est de la glace liquéfiée.	Water is liquid ice.
danser	v.to dance	Avez-vous envie de danser?	Do you want to dance?
quartier	n.neighborhood	Je connais ce quartier.	I know this neighborhood.
lorsque	conj.when	Lorsque je me trouve avec toi, je suis heureux.	When I am with you, I am happy.
douleur	n.pain	Je vais vous donner quelque chose pour la douleur.	I will give you something for the pain.
ravi	adj.delighted	Il sera ravi de te voir.	He will be delighted to see you.
spectacle	n.show	Je veux voir un spectacle.	I want to see a show.
proche	adj.close	Je veux savoir si c'est proche.	I want to know if it's close.
d'abord	adv.firstly	Je vais d'abord lire les instructions.	I will read the instructions first.
honnête	adj.honest	Sois honnête avec moi.	Be honest with me.
camion	n.truck	Le camion est parti.	The truck left.
assurer	v.to ensure	Le logiciel assure le bon fonctionnement de la machine.	The software ensures the machine works properly.
projet	n.project	Je suis fier de faire partie de ce projet.	I am proud to be part of this project.
parole	n.word	Il est fiable et tient toujours parole.	He is trustworthy and always keeps his word.
gosse	n.kid	Mets le gosse au lit !	Put the kid in bed!
discuter	v.to discuss	Elle avait quelque chose à discuter avec lui.	She had something to discuss with him.
remettre	v.to put back	J'ai remis le livre sur l'étagère.	I put the book back on the shelf.
copain	n.friend	Les enfants ont passé l'après-midi avec leurs copains.	The children spent the afternoon with their friends.
épouser	v.to marry	Je vous aime et je veux vous épouser.	I love you and I want to marry you.
portable	adj n.cell phone	J'utilise un portable pour appeler mes amis.	I use a mobile phone to call my friends.
choisir	v.to choose	C'est dur de choisir.	It's hard to choose.
rappeler	v.to remember	Je ne me rappelle plus très bien.	I no longer remember very well.
offrir	v.to offer	Puis-je vous offrir une boisson ?	Can I offer you a drink?
pression	n.pressure	Mes parents me mettent la pression.	My parents are pressuring me.
découvrir	v.to discover	Je ferai tout mon possible pour découvrir qui a fait ça.	I will do my best to discover who did this.
court	adj.short	Un résumé doit être court et concis.	A summary has to be short and concise.
bain	n.bath	Votre bain est prêt.	Your bath is ready.
détruire	v.to destroy	La tempête menace de détruire les récoltes.	The storm threatens to destroy the crops.
chanter	v.to sing	C'est à ton tour de chanter.	It's your turn to sing.
énorme	adj.huge	C'est énorme.	It's huge.
envers	prep.towards	Il est bien disposé envers elle.	He’s well disposed towards her.
réfléchir	v.to think	Donne-moi un peu de temps pour réfléchir.	Give me some time to think.
pierre	n.stone	J'ai un coffre plein de pierres précieuses.	I have a chest full of precious stones.
lâche	n.coward	Il est lâche.	He’s a coward.
enlever	v.to remove, to take off	Je vais enlever les vieux livres de l'étagère.	I will remove the old books from the shelf.
sauter	v.to jump	Il a défié son ami de sauter.	He challenged his friend to jump.
nécessaire	adj.necessary	Parfois il est nécessaire de dire la vérité.	Sometimes it is necessary to tell the truth.
immédiatement	adv.immediately	Arrête immédiateme	Stop immediately!
arranger	v.arrange	Pouvons-nous arranger ça ?	Can we fix this?
couteau	n.knife	C'est un couteau de cuisine.	It is a kitchen knife.
durant	during	Il court durant une heure tous les matins.	He runs for an hour every morning.
ancien	adj.old	Ce livre est très ancien.	This book is very old.
vent	n.wind	Quel vent !	What a wind!
tourner	v.to turn (right or left)	Tourne à la deuxième à gauche.	Turn to the second left.
repas	n.meal	Le repas est prêt.	The meal is ready.
taille	n.size	Regardez la taille de ce truc !	Look at the size of this thing!
politique	adj n.politics	En période électorale, mes amis aiment discuter de politique.	At election time, my friends enjoy discussing politics.
papier	n.paper	Les livres sont faits de papier.	Books are made of paper.
contrat	n.contract	Nous avons un contrat.	We have a contract.
chat	n.cat	Le chat est dans la maison.	The cat is in the house.
beauté	n.beauty	C'est une vraie beauté.	It is a real beauty.
ordinateur	n.computer	Je vais peut-être acheter un ordinateur tout neuf.	Maybe I will buy a brand new computer.
carrière	n.career	Sa carrière est une inspiration pour ses pairs.	Her career is an inspiration for her peers.
bonheur	n.happiness	Je sais que vous voulez mon bonheur.	I know you want my happiness.
mémoire	n.memory	Mon frère a une bonne mémoire.	My brother has a good memory.
permis	n.license	Un jour, ils vont te prendre ton permis de conduire.	One day, they will take your driver's license.
contraire	adj n.opposite	Elle fait toujours le contraire.	She always does the opposite.
joyeux	adj.happy	Le climat à bord du bateau était joyeux.	The mood on board the boat was happy.
parmi	prep.among	Il n'y a que dix garçons parmi tous les élèves.	There are only ten boys among all of the pupils.
crise	n.crisis	Le président a convoqué une réunion pour répondre à la crise.	The president called a meeting to address the crisis.
marrant	adj.funny	C'est très marrant.	It's very funny.
série	n.series	J'ai hâte de voir le dernier épisode de cette série.	I am eager to watch the last part of this series.
piste	n.trail	Le chasseur a suivi la piste du cerf.	The hunter followed the deer's trail.
puisque	conj.since	Puisque je suis ici, laissez-moi vous aider.	Since I am here, let me help you.
maladie	is not contagious.n.	Ma maladie n'est pas contagieuse.	My disease 
cible	n.target	Tu as touché au centre de la cible.	You hit the center of the target.
fil	n.thread	Le fil est utilisé en broderie.	Thread is used in embroidery.
pleurer	v.to cry	Allons ! Ce n'est pas la peine de pleurer pour ça.	Come on! There is no need to cry over this.
totalement	adv.totally	Le mien est totalement différent.	Mine is totally different.
remercier	v.to thank someone	Je veux vous remercier pour tout ce que vous avez fait.	I want to thank you for all that you have done.
entier	adj n.whole	Le monde entier nous regarde.	The whole world is watching us.
couleur	n.color	De quelle couleur sont-ils?	What color are they?
île	n.island	Il y a une petite île au milieu du lac.	There is a small island in the middle of the lake.
fermer	v.to close	Puis-je vous demander de fermer la fenêtre ?	Can I ask you to close the window?
soldat	n.soldier	Cet homme est soldat.	This man is a soldier.
étage	n.floor (level of a building)	Mon bureau est au quatrième étage.	My office is on the fourth floor.
épouse	n.wife	Voici mon épouse.	This is my wife.
régler	v.to settle	Mon père m'a aidé à régler mes dettes.	My father helped me to settle my debts.
frais	adj.fresh	Je veux boire quelque chose de frais.	I want to drink something fresh.
langue	n.language	Je peux comprendre ta langue.	I can understand your language.
mentir	v.to lie	J'ai promis à mes amis que je ne leur mentirais jamais.	I promised my friends that I would never lie to them.
sacré	adj.sacred	Beaucoup de religions ont des textes sacrés.	Many religions have holy writings.
poisson	n.fish	Vous aimez le poisson ?	Do you like fish?
frapper	v.to knock	Veuillez frapper avant d'entrer.	Please knock before entering.
courir	v.to run	Un guépard peut courir très rapidement.	A cheetah can run very fast.
bouger	v.to move	Je leur dis de ne pas bouger.	I tell them not to move.
rejoindre	v.to rejoin	Je vais rejoindre le club de golf le mois prochain.	I will join the golf club next month.
bleu	adj.blue	Le bleu vous va très bien.	Blue suits you very well.
destin	n.destiny	C'est ton destin.	It is your destiny.
faible	adj.weak	J'ai un rhume et je me sens très faible.	I have a cold and feel very weak.
lait	n.milk	Je veux du lait.	I want milk.
adieu	int.farewell	Adieu!	Farewell!
pont	n.bridge	Ce pont est très beau.	This bridge is very beautiful.
costume	n.suit	Ce costume te va bien.	This suit looks good on you.
attraper	v.to catch	Je vais te montrer comment attraper un poisson.	I'll show you how to catch a fish.
partenaire	n.partner	Je suis ton partenaire.	I am your partner.
goût	n.taste	C'est une question de goût.	It is a matter of taste.
sourire	n v.smile	Elle lui a envoyé un grand sourire.	She sent him a big smile.
bouteille	n.bottle	La bouteille est pleine.	The bottle is full.
formidable	adj.wonderful	Tu es une femme formidable !	You are a wonderful woman!
tribunal	n.court	On se verra au tribunal.	We'll see you in court.
français	adj n.french	Je connais un peu de français.	I know a little French.
foi	n.faith	C'est un homme de foi.	He is a man of faith.
évidemment	adv.obviously	Évidemment, vous pouvez rester.	Obviously, you can stay.
chasse	n.hunt	Ils ont fait une bonne chasse.	They had a good hunt.
amener	v.to bring (a person)	J'amène mon fils à l'école.	I bring my son to school.
os	n.bone	Vous êtes-vous jamais cassé un os ?	Have you ever broken a bone?
afin	in order to	Je prends des leçons afin d'apprendre le français.	I'm taking lessons in order to learn French.
gâteau	n.cake	Ma mère fait le meilleur gâteau au chocolat.	My mother makes the best chocolate cake.
cou	n.neck	Notre entraîneur porte un sifflet autour du cou.	Our coach carries a whistle around his neck.
couper	v.to cut	Tu devrais te couper les cheveux.	You should cut your hair.
utile	adj.useful	Je veux être utile.	I want to be useful.
jambe	n.leg	Le chien m'a mordu la jambe.	The dog bit my leg.
bref	adj.brief	Le résumé de deux minutes était bref mais intéressant.	The two-minute summary was brief but interesting.
morceau	n.piece	Elle lui a donné un morceau de papier.	She gave him a piece of paper.
raconter	v.to tell	Je vais te raconter une histoire.	I'll tell you a story.
justement	adv.exactly	C’est justement ce qu’il fallait faire.	That’s exactly what needed doing.
discours	n.speech	Elle avait peur de faire un discours.	She was afraid to give a speech.
rapidement	adv.quickly	Je veux faire ça rapidement.	I want to do this quickly.
méchant	adj.mean	Vous êtes si méchant.	You are so mean.
jouet	n.toy	J'ai finalement acheté le jouet.	I finally bought the toy.
lien	n.link	Il y a un lien évident entre la nutrition et la santé.	There is an obvious link between nutrition and health.
appareil	n.device	L'appareil doit être placé sur un sol plat.	The device must be placed on level ground.
ange	n.angel	Tu es un ange.	You are an angel.
compter	v.to count	Mon fils sait compter jusqu'à vingt.	My son can count to twenty.
malgré	prep.despite	Malgré l'embouteillage, nous sommes arrivés à temps.	Despite the traffic jam, we arrived on time.
reprendre	v.to resume	Je veux reprendre le cours de ma vie.	I want to resume the course of my life.
magie	n.magic	Ça marche comme par magie.	It works like magic.
chapeau	n.hat	Il me faut un chapeau.	I need a hat.
décider	v.to decide	C'est à toi de décider ce que tu veux faire.	It is up to you to decide what you want to do.
agir	v.to act	Je n'ai jamais vu mon chat agir comme ça.	I have never seen my cat act like that.
vendredi	n.friday	On fait une fête vendredi soir.	We have a party Friday evening.
malheureusement	adv.unfortunately	Malheureusement, j'ai perdu le pari.	Unfortunately, I have lost the bet.
mince	adj.thin	La couche de glace était mince et fragile.	The layer of ice was thin and fragile.
saison	n.season	Il fait chaud pour la saison.	It is hot for the season.
gérer	v.to manage	Le nouvel employé gère les comptes des clients.	The new employee manages the client accounts.
pain	n.bread	Je vais faire du pain.	I'm going to make bread.
règle	n.rule	Je comprends la règle.	I understand the rule.
malin	adj.smart	Ce garçon est malin.	This boy is smart.
toit	n.roof	Le chat est sur le toit.	The cat is on the roof.
doux	adj.soft	Le tissu de ma robe est très doux.	The fabric of my dress is very soft.
coffre	n.trunk	Ferme le coffre.	Close the trunk.
couverture	n.blanket	Je veux une couverture.	I want a blanket.
arbre	n.tree	Cet arbre est plus vieux que cette voiture.	This tree is older than this car.
réparer	v.to repair	Je pense que je peux réparer ça.	I think I can fix this.
lever	n v.to lift	Les élèves doivent lever la main s'ils ont une question.	Students must raise their hand if they have a question.
enchanté	adj.delighted	Je suis enchanté de vous rencontrer.	I am delighted to meet you.
apporter	v.to bring (something)	Le serveur nous a apporté la note.	The waiter brought us the check.
jardin	n.garden	Mon père est dans le jardin.	My father is in the garden.
partager	v.to share	Je veux le partager avec vous.	I want to share it with you.
plage	n.beach	Notre maison est face à la plage.	Our house is facing the beach.
échapper	v.to escape	La proie a réussi à échapper aux chasseurs.	The quarry managed to escape from the hunters.
revoir	v.to see again	Revoir mon ami m'a rendu joyeux et heureux.	Seeing my friend again made me cheerful and happy.
également	adv.also	Tu es également mon meilleur ami.	You are also my best friend.
folie	n.madness	C'est la folie.	This is madness.
samedi	n.saturday	Pourriez-vous réfléchir à vous occuper de mes enfants samedi prochain ?	Could you think about looking after my children next Saturday?
mode	n.fashion	Elle adore la mode et est toujours habillée élégamment.	She loves fashion and is always dressed elegantly.
maire	n.mayor	Il connaît le maire.	He knows the mayor.
inquiéter	v.to worry	Vous aviez raison de vous inquiéter.	You were right to worry.
recevoir	v.to receive	Il est mieux de donner que de recevoir.	It is better to give than to receive.
réel	adj n.real	C'est ici le monde réel.	This is the real world.
poids	n.weight	Elle prend du poids.	She is gaining weight.
prévenir	v.to warn	J'ai prévenu mon ami que je serais en retard.	I warned my friend that I would be late.
suivant	adj.next	Je lui ai dit de venir le jour suivant.	I told him to come the next day.
poche	n.pocket	C'est dans la poche!	It's in the pocket!
vitesse	is very high now.n.	La vitesse du vent est très élevée maintenant.	The wind speed 
fantôme	n.ghost	Es-tu un fantôme ?	Are you a ghost?
viande	n.meat	Je mange beaucoup de viande.	I eat a lot of meat.
poulet	n.chicken	Elle a acheté un poulet.	She bought a chicken.
file	n.line of objects placed one after another	Le directeur a ordonné aux enfants de se mettre en file.	The headmaster directed the children to stand in line.
abandonner	v.to give up	Je choisis de persévérer plutôt que d'abandonner.	I choose to persevere rather than giving up.
embrasser	v.to kiss	Je veux vous embrasser.	I want to kiss you.
dimanche	n.sunday	Hier c'était dimanche, pas samedi.	Yesterday was Sunday, not Saturday.
amusant	adj.fun	La fête était vraiment amusante.	The party was really fun.
cent	num.hundred	Tu as raison à cent pour cent.	You are one hundred percent right.
retraite	n.retirement (the portion of one's life after retiring from one's career)	Nous avons organisé une fête pour la retraite de notre collègue.	We organized a party for our colleague's retirement.
étranger	adj n.foreigner	Elle est mariée à un étranger.	She is married to a foreigner.
paradis	heaven	Le sentier entre l'enfer et le paradis est étroit.	The path between hell and heaven is narrow.
directement	adv.directly	Je suis allé directement au lit.	I went straight to bed.
champ	n.field	Une clôture entoure le champ.	A fence surrounds the field.
débarrasser	rid (get rid of)	De quoi puis-je me débarrasser ?	What can I get rid of? 
manquer	v.to miss	Il est rare que ma fille manque l'école.	It is unusual for my daughter to miss school.
doigt	n.finger	Elle porte une bague au doigt.	She wears a ring on her finger.
piège	n.trap	Cela pourrait être un piège.	This could be a trap.
marque	n.brand (clothing, product, etc.)	Quelle est la marque?	What is the brand?
perte	n.loss	J'ai signalé la perte de mon portefeuille à la police.	I reported the loss of my wallet to the police.
créer	v.to create	J'ai créé un profil sur un nouveau réseau social.	I created a profile on a new social network.
nettoyer	v.to clean	Il est temps de nettoyer ta chambre.	It's time to clean your room.
note	n.grade	Il a obtenu la note 15 sur 20 pour ça composition français.	He received a grade of 15 out of 20 for his french essay.
franchement	adv.honestly	Il a parlé franchement de son passé.	He spoke frankly about his past.
bâtiment	n.building	Le nouveau bâtiment est énorme.	The new building is huge.
heureusement	adv.fortunately	Heureusement, mon fils a été épargné par la maladie.	Fortunately, my son was spared the disease.
connaissance	n.knowledge	Ma sœur a une bonne connaissance du français.	My sister has a good knowledge of French.
mensonge	n.lie	Il a décidé de raconter un mensonge plutôt que de dire la vérité.	He decided to spin a lie instead of telling the truth.
joindre	v.to join	Tu peux te joindre.	You can join.
convaincre	v.to convince	C'est mon travail de vous convaincre.	It's my job to convince you.
nerveux	adj.nervous	Je suis toujours très nerveux avant un examen.	I am always very nervous before an exam.
pantalon	n.pants	Où est mon pantalon ?	Where are my pants?
douche	n.shower	Prends une douche !	Take a shower!
bataille	n.battle	Nous avons gagné la bataille.	We have won the battle.
sentiment	n.feeling	Je me rappelle ce sentiment.	I remember this feeling.
traitement	n.treatment	Le patient a bien réagi au traitement.	The patient responded well to the treatment.
volonté	n.will	Une équipe doit manifester la volonté de coopérer.	A team needs to show willingness to cooperate.
souci	n.worry	J'ai oublié mes soucis après une journée à la plage.	I forgot my worries after a day at the beach.
reposer	v.to rest	Je pense que vous devriez vous reposer un moment.	I think you should rest for a while.
victoire	n.victory	Le nouveau joueur a mené l'équipe à la victoire.	The new player led the team to victory.
queue	n.line up	Il y avait une longue queue devant l'attraction touristique.	There was a long line in front of the tourist attraction.
désormais	adv.from now on	Désormais, c'est moi le roi.	From now on, I'm the king.
paquet	n.package	Ouvre le paquet.	Open the package.
autrement	adv.otherwise	Je pense autrement.	I think otherwise.
lancer	v.to throw	Sais-tu lancer ?	Can you throw?
infirmière	n.nurse	L'infirmière a bandé le bras du patient.	The nurse bandaged the patient's arm.
métier	n.profession	Son métier est médecin.	His profession is doctor.
bague	n.ring	Je ne veux pas la bague.	I don't want the ring.
aveugle	adj n.blind	L'homme est aveugle.	The man is blind.
veste	n.jacket	Où est ma veste ?	Where's my jacket?
propriétaire	n.owner	Qui est le propriétaire de cette maison ?	Who is the owner of this house?
fuir	v.to flee	Le bruit a fait fuir tous les animaux.	The noise caused all the animals to flee.
oiseau	n.bird	Cet oiseau sait voler.	This bird knows how to fly.
retirer	v.to withdraw	Il a retiré la clé de la serrure.	He removed the key from the lock.
récemment	adv.recently	Le musée a récemment modernisé son système de sécurité.	The museum has recently upgraded its security system.
célèbre	adj.famous	Ce type est célèbre.	This guy is famous.
fiston	n.son	Mon fiston a six ans.	My son is 6 years old.
vert	adj.green	Le vert te va bien.	Green looks good on you.
assurance	n.insurance	Ma voiture est couverte par mon assurance.	My car is covered by my insurance.
charmant	adj.charming	C'est charmant.	It is charming.
chemise	n.shirt	Elle lui a acheté une chemise à porter à la fête.	She bought him a shirt to wear to the party.
ventre	n.stomach	Elle dort sur le ventre.	She sleeps on her stomach.
atteindre	v.to reach	L'alpiniste a atteint le sommet de la montagne.	The mountaineer reached the peak of the mountain.
virer	n.fire	Tu dois virer la nouvelle standardiste.	You have to fire the new switchboard operator.
pluie	n.rain	Le niveau de l'eau était monté après la pluie.	The water level had risen after the rain.
couche	n.layer (of soil, snow, paint, etc.)	Une couche de givre recouvrait les fleurs.	A layer of frost blanketed the flowers.
voleur	n.thief	Je sais qui est le voleur.	I know who the thief is.
réveiller	v.to wake up	Je réveille mes enfants tôt tous les matins.	I wake my children early every morning.
souris	n.mouse	Le chat a mangé la souris.	The cat ate the mouse.
ombre	n.shadow	Il a peur de son ombre.	He is afraid of his shadow.
repos	n.rest	Le repos est important.	Rest is important.
blesser	v.to injure	Vous pourriez vous blesser.	You could injure yourself.
neige	n.snow	Ce matin, le sol était couvert de neige.	This morning, the ground was covered with snow.
lundi	n.monday	Je serai là-bas lundi soir.	I will be there Monday evening.
permettre	v.to allow	Je refuse de le permettre.	I refuse to allow it.
surveiller	v.to supervise	Pouvez-vous rester et surveiller les enfants ?	Can you stay and supervise the children?
chaise	n.chair	Le chien est sur la chaise.	The dog is on the chair.
hâte	adj.eager	J'ai hâte de voir le dernier épisode de cette série.	I am eager to watch the last part of this series.
véritable	adj.true	Je veux trouver le véritable amour.	I want to find true love.
siège	n.seat	Tu es assis dans mon siège.	You are sitting in my seat.
traduction	n.translation	J'ai choisi la traduction du mot la plus appropriée.	I chose the most suitable translation of the word.
montagne	n.mountain	Sa maison est au pied de la montagne.	His house is at the foot of the mountain.
gorge	n.throat	Une tasse de thé calmera ton mal de gorge.	A cup of tea will soothe your sore throat.
sommeil	n.sleep	Le bruit de la rue n'a pas troublé mon sommeil.	The noise in the street did not trouble my sleep.
rivière	n.river	Allons manger au bord de la rivière.	Let's go eat by the river.
crayon	n.pencil	Il a placé son crayon derrière l'oreille.	He placed his pencil behind the ear.
sembler	v.to appear to be	Le nouveau médicament semble être très efficace.	The new medication appears to be very effective.
titre	n.title	Le titre d'un article doit attirer l'attention du lecteur.	The title of an article must catch the reader's attention.
ours	n.bear	Les loups et les ours sont des animaux sauvages.	Wolves and bears are wild animals.
lunettes	n.glasses (for vision)	Avec ces lunettes, je vois bien mieux.	With these glasses, I can see much better.
exploser	v.to explode	Ça va exploser !	It will explode!
évident	adj.obvious	C'était évident.	It was obvious.
examen	n.test	Hier, j'ai passé un examen à l'école.	Yesterday, I took an examination at school.
respirer	v.to breathe	L'air que nous respirons est invisible.	The air we breathe is invisible.
plat	adj n.dish	Le plat du jour est du poisson.	The dish of the day is fish.
survivre	v.to survive	Je peux survivre à ça.	I can survive this.
auprès	adv.nearby	Quand je suis auprès de toi, je me sens bien.	When I am close to you, I feel fine.
forêt	n.forest	La route passe par la forêt.	The road passes through the forest.
amitié	n.friendship	La confiance est le fondement de l'amitié.	Trust is the foundation of friendship.
blessure	n.injury	Elle est celle qui a pris soin de sa blessure.	She is the one who took care of her injury.
humeur	n.mood	Je vois que tu es de bonne humeur.	I see that you are in a good mood.
puissance	n.power	La puissance fait le droit.	Power makes the law.
casser	v.to break	Vous allez le casser si vous ne faites pas attention.	You will break it if you are not careful.
crier	v.to shout	Tu n'as pas besoin de crier.	You don't have to shout.
pousser	v.to push	Pourrais-tu pousser la porte pour l'ouvrir ?	Could you push the door to open it?
gare	n.train station	Je pris un taxi pour la gare.	I took a taxi to the train station.
midi	n.noon	Il vient à midi.	He comes at noon.
dessous	adv.beneath	Le nom du tableau est écrit dessous.	The name of the painting is written below.
annonce	n.advertisement	La maison correspond à la description dans l'annonce.	The house matches the description in the advertisement.
oreille	n.ear	Les éléphants ont de très grandes oreilles.	Elephants have very large ears.
usine	n.factory	Mon père travaille dans une usine.	My father works in a factory.
nombreux	adj.plentiful	Les belles plages sont nombreuses dans la région.	Beautiful beaches are plentiful in the region.
vache	n.cow	La vache nous donne du lait.	The cow gives us milk.
prudent	adj.careful	Je serai plus prudent.	I will be more careful.
épée	n.sword	Donne-moi ton épée.	Give me your sword.
sage	adj n.wise	Elle est très sage.	She is very wise.
libérer	v.to free	Le détenu a été libéré la semaine dernière.	The prisoner was freed last week.
tuer	v.to kill	Le chevalier a tué son adversaire pendant la bataille.	The knight killed his opponent during the battle.
château	n.castle	Il y a un château dans ma ville.	There is a castle in my town.
fer	n.iron	Mon marteau est en fer.	My hammer is made of iron.
réellement	adv.actually	Sont-elles réellement amies ?	Are they actually friends?
côte	n.coast	Je suis de la côte Ouest.	I am from the west coast.
quiconque	whoever / anyone	Nous ne devons pas juger quiconque.	We are not supposed to judge anyone.
délicieux	adj.delicious	Le gâteau est délicieux.	The cake is delicious.
chaleur	n.warmth	Je me rappelle la chaleur de ses bras.	I remember the warmth of his arms.
essence	n.gasoline	Ma petite voiture ne consomme pas beaucoup d'essence.	My small car does not consume much petrol.
soutien	n.support (physical or physchological)	Le candidat a obtenu le soutien de son parti.	The candidate obtained the support of his party.
traiter	v.to treat	Je sais comment traiter une dame.	I know how to treat a lady.
herbe	n.grass	J'aime bien regarder mes chats jouer dans l'herbe.	I like watching my cats play in the grass.
traverser	v.to cross	Elle a aidé le vieil homme à traverser la rue.	She helped the old man to cross the street.
menteur	liar	Ton père est le pire menteur au monde.	Your father is the worst liar in the world.
sombre	adj.dark	Le ciel était très sombre.	The sky was very dark.
bosser	work	J'adore bosser ici.	I love working here.
puissant	adj.powerful	On dit que ce canon est très puissant.	It is said that this cannon is very powerful.
cependant	conj.however	Mon train a du retard. Cependant, j'arriverai assez tôt.	My train is late. However, I will arrive early enough.
construire	v.to build	Je construis un château de sable avec mes enfants.	I am building a sandcastle with my children.
agence	n.agency	Je travaille pour une agence de voyage.	I work for a travel agency.
lendemain	n.next day	Le lendemain, la neige avait recouvert la ville entière.	The next day, snow had covered the whole town.
disparaître	v.to disappear	Tu dois disparaître.	You have to disappear.
fumer	v.to smoke	Le vieil homme fume une pipe.	The old man smokes a pipe.
horloge	n.clock	Regarde l'horloge.	Look at the clock.
maintenir	v.to maintain	Le capitaine a maintenu l'ordre à bord du navire.	The captain maintained order on the ship.
souffrir	suffer	Elles vont toutes souffrir de cette décision.	They will all suffer from this decision.
fromage	n.cheese	Je voudrais un morceau de fromage.	I would like a piece of cheese.
piscine	n.swimming pool	La piscine est pleine.	The pool is full.
billet	n.ticket	Elle a eu le billet pour rien.	She got the ticket for nothing.
résoudre	solve / resolve	Mais il reste évidemment des problèmes à résoudre.	But of course there are still problems to be solved.
chair	This fish has a very tender flesh it is delicious.	Ce poisson a une chair très tendre 	 il est délicieux.
résultat	n.result	On verra le résultat.	We will see the result.
taire	v.to hush up	Tu peux te taire.	You can stop talking.
déranger	v.to disturb	Le garçon n'a pas voulu déranger sa mère au travail.	The boy did not want to disturb his mother at her work.
concours	n.competition	Elle a gagné le concours de chant.	She won the singing competition.
crâne	skull	Laissez-moi ouvrir son crâne et mesurer son cerveau.	Let me open his skull and measure his brain.
élevé	adj.high	Le prix de cette voiture est très élevé.	The price of this car is very high.
laver	v.to wash	Tu dois te laver les mains.	You have to wash your hands.
jaloux	adj.jealous	Ils sont jaloux de nous.	They are jealous of us.
enfance	n.childhood	Son enfance était dure.	His childhood was hard.
chouette	adj.cool	Sa voiture est vraiment chouette.	His car is really cool.
profiter	v.to enjoy	Profitez du soleil.	Enjoy the sun.
caisse	n.box	La caisse était pleine de livres.	The box was full of books.
gaffe	n.blunder	Il était gêné par sa gaffe à la soirée.	He was embarrassed by his blunder at the party.
poitrine	n.chest	La femme tient son bébé contre sa poitrine.	The woman holds her baby to her chest.
sucre	n.sugar	Il aime le café sans sucre.	He likes coffee without sugar.
siècle	n.century	L'histoire de cette ville couvre quatre siècles.	The history of this town covers four centuries.
geste	n.gesture	J'apprécie le geste.	I appreciate the gesture.
étudier	v.to study	Tu dois étudier pendant toute ta vie.	You have to study for your whole life.
forcément	adv.necessarily	L'ethnicité n'est pas forcément la même chose que la nationalité.	Ethnicity is not necessarily the same thing as nationality.
cloche	n.bell	Je dois partir quand la cloche sonne.	I need to leave when the bell rings.
chute	n.fall	L'alpiniste a survécu à sa chute.	The rock climber survived the fall.
joueur	n.player	Il est le meilleur joueur de notre équipe.	He is the best player on our team.
peinture	n.painting	Il adore la peinture.	He loves painting.
tenue	n.outfit	Elle va aussi choisir ma tenue.	She is also going to choose my outfit.
marine	n.navy	Mon père était dans la Marine.	My father was in the Navy.
plainte	n.complaint	Nous avons eu une plainte.	We had a complaint.
foyer	n.household	Je vis dans un foyer heureux.	I live in a happy household.
manteau	n.coat	Il me faut un manteau.	I need a coat.
incendie	n.fire	Il a risqué sa vie pour sauver sa famille de l'incendie.	He risked his life to save his family from the fire.
mener	v.to lead	Je veux simplement mener une vie normale.	I just want to lead a normal life.
cauchemar	n.nightmare	Peut-être que c'était juste un cauchemar.	Maybe it was just a nightmare.
prêtre	n.priest	Le prêtre qui parle français sera là la semaine prochaine.	The priest who speaks French will be there next week.
lapin	n.rabbit	Les lapins peuvent digérer tous les légumes.	Rabbits can digest every vegetable.
scientifique	 Vast, imaginative and ambitious.adj n.	C'est un grand scientifique, rapide, imaginatif et ambitieux.	He is a great scientist. 
corde	n.rope	Tenez la corde.	Hold the rope.
propriété	n.property	C'est une propriété privée.	It is private property.
deviner	v.to guess	Devine qui a gagné.	Guess who won.
hiver	n.winter	L'hiver arrive bientôt.	Winter is coming soon.
jus	n.juice	Bois ce jus !	Drink this juice!
couloir	n.hallway	Le bureau du directeur est au fond du couloir.	The manager's office is at the end of the hallway.
poupée	n.doll	Je lui ai acheté une poupée.	I bought her a doll.
admettre	v.to admit	Je dois admettre que je n'en ai jamais entendu parler.	I must admit that I have never heard of it.
foule	n.crowd	Il a disparu dans la foule.	He disappeared from the crowd.
réseau	n.network	À l'école, tous les ordinateurs sont sur le même réseau.	At school, all computers are on the same network.
entraînement	n.training	L'entraînement m'a permis d'améliorer ma performance.	Training helped me improve my performance.
pardonner	v.to forgive	Mon patron a pardonné mon retard.	My boss forgave my lateness.
ascenseur	n.elevator	Nous pouvons prendre l'ascenseur jusqu'au troisième étage.	We can take the elevator to the third floor.
liaison	n.connection	Le modem a établi une liaison avec le réseau.	The modem established a connection with the network.
traîner	v.to drag	Mon fils a traîné sa grande valise.	My son dragged his large suitcase.
vélo	n.bike	Pour ton anniversaire, je te donnerai un vélo.	For your birthday, I will give you a bicycle.
anneau	n.ring	Il portait plusieurs anneaux en or à la main gauche.	He wore several gold rings on his left hand.
coopérer	v.to cooperate	Nous serons heureux de coopérer.	We will be happy to cooperate.
estomac	n.stomach	Mon estomac est vide.	My stomach is empty.
répéter	v.to repeat	Répète après moi.	Repeat after me.
curieux	adj.curious	Je dois admettre que je suis curieux.	I must admit that I am curious.
mardi	n.tuesday	Le mardi, je vais à la gym.	On Tuesdays, I go to the gym.
soudain	adjsudden	Son succès soudain n'est pas un hasard.	His sudden success is not a fluke.
ballon	n.ball	Tiens le ballon des deux mains.	Hold the ball with both hands.
combattre	v.fight	Je veux combattre.	I want to fight.
bouton	n.button	Vous pouvez régler le volume avec ce bouton.	You can adjust the volume with this button.
tâche	n.task	Ça a été la tâche la plus difficile de ma vie.	It has been the most difficult task of my life.
réussir	v.to succeed	Elle est sûre de réussir.	She is sure to succeed.
conseiller	v.to advise	Un groupe d'experts conseille le gouvernement.	A group of experts is advising the government.
brûler	v.to burn	J'ai utilisé une allumette pour brûler le papier.	I used a match to burn the paper.
rater	v.to fail	J'ai raté l'examen.	I failed the exam.
gloire	n.glory	Ce monument magnifique est la gloire de la ville.	This beautiful monument is the glory of the town.
nana	n.girl (particularly a beautiful one)	Je sais que tu as une nana.	I know you have a girl.
lourd	adj.	Ne penses-tu pas que ça pourrait être un peu lourd ?	Don't you think it could be a little heavy?
remplacer	v.to replace	Je peux le remplacer.	I can replace it.
affreux	adj.horrible	Elle a peint sa maison d'un vert affreux.	She painted her house a horrible green.
enterrement	n.burial	Beaucoup de chefs d'État sont venus à l'enterrement du roi.	Many world leaders came to the burial of the king.
tapis	n.carpet	Le tapis de ma chambre est vert.	The carpet in my bedroom is green.
tenter	v.to try	Je vais tenter le coup.	I will give it a try.
réaliser	v.to achieve	Notre équipe a réalisé le meilleur score aujourd'hui.	Our team achieved the best score today.
lâcher	v.to release	J'ai lâché le ballon.	I released the balloon.
baisse	n.decrease	Nous avons remarqué une baisse de la productivité.	We noticed a decrease in productivity.
venger	v.to revenge	Il a provoqué son ennemi en duel pour venger le roi.	He challenged his enemy to a duel to revenge the king.
récompense	n.reward	Quelle est ma récompense?	What is my reward?
poursuivre	v.to pursue	Les deux entreprises poursuivent un objectif commun.	The two companies pursue a common goal.
loup	n.wolf	Est-ce un loup ?	Is it a wolf?
navire	n.ship	Le capitaine contrôle tout le navire.	The captain controls the entire ship.
fleur	n.flower	C'est une fleur tellement belle !	It is such a beautiful flower! 
pratique	adj n.practical	C'était pratique.	It was practical.
jeudi	n.thursday	Jeudi est le quatrième jour de la semaine de travail.	Thursday is the fourth day of the working week.
célibataire	adj n.single	Il est jeune et célibataire.	He is young and single.
attirer	v.to attract	La nuit, la lumière attire des insectes.	At night, light attracts insects.
étonnant	adj.surprising	Le scientifique a trouvé les résultats de l'expérience étonnants.	The scientist found the results of the experiment surprising.
rythme	n.pace	La société évolue à un rythme sans précédent.	Society is changing at an unprecedented pace.
tempête	n.storm	La tempête a fait arrêter le train.	The storm caused the train to stop.
lutte	n.fight	Je soutiens la lutte contre la pauvreté.	I support the fight against poverty.
accompagner	v.to accompany	Je vais vous accompagner.	I will accompany you.
ceinture	n.belt (item of clothing)	Je boucle toujours ma ceinture de sécurité dans la voiture.	I always buckle my seat belt in the car.
personnage	n.character (of a story)	Il y a trop de personnages dans le livre.	There are too many characters in the book.
mars	n.march (month)	Mars est le troisième mois de l'année.	March is the third month of the year.
vingt	num.twenty	Je dois faire cuire le gâteau au four pendant vingt minutes.	I need to bake the cake in the oven for twenty minutes.
collier	n.necklace	L'actrice portait un beau collier de diamant.	The actress was wearing a beautiful diamond necklace.
canapé	n.couch	Je me suis réveillé sur le canapé.	I woke up on the couch.
nourrir	v.to feed	Il nourrit souvent son chat avec du poisson.	He often feeds fish to his cat.
singe	n.monkey	As-tu déjà vu un singe?	Have you ever seen a monkey?
pêche	n.fishing	Avez-vous un bateau de pêche ?	Do you have a fishing boat?
haine	n.hatred	La haine prend souvent sa source dans l'ignorance.	Hatred is often rooted in ignorance.
tromper	v.to deceive	Son apparence et son charme ont trompé beaucoup de gens.	His appearance and charm deceived many people.
pis	worse / worst	Les choses allèrent de mal en pis.	Things went from bad to worse.
écran	n.screen	Les instructions à l'écran sont lisibles et claires.	The instructions on screen are readable and clear.
miel	n.honey	J'aime le miel.	I like honey.
malheur	n.misfortune	Quel malheur !	What a misfortune!
arme	n.weapon	Je sais que vous avez une arme.	I know you have a weapon.
cerveau	n.brain	Les mots croisés sont très stimulants pour le cerveau.	Crosswords are very challenging for the brain.
explication	n.explanation	Je veux une explication.	I want an explanation.
vierge	adj n.blank / untouched	J'ai pris des notes sur une feuille vierge.	I took notes on a blank sheet of paper.
palais	n.palace	Le roi vit dans un palais.	The king lives in a palace.
identifier	v.to identify	Pouvez-vous les identifier ?	Can you identify them?
gâcher	v.to ruin	Ne gâche pas ma fête.	Don't ruin my party.
lent	adj.slow	Mon frère marche vite, mais ma sœur est lente.	My brother walks quickly, but my sister is slow.
élève	n.student	Vous êtes un bon élève, mais vous avez encore beaucoup à apprendre.	You are a good student, but you still have a lot to learn.
monnaie	n.change (money back from a transaction)	Je garde ma petite monnaie.	I keep my loose change.
davantage	adv.more	Il voulait en savoir davantage sur les fleurs.	He wanted to know more about flowers.
roman	n.novel	Son dernier roman est une histoire d'amour.	His latest novel is a love story.
soif	n.thurst	Je vais mourir de soif.	I am going to die of thirst.
étoile	n.star	Le soleil est une étoile.	The sun is a star.
concentrer	v.to concentrate	Tu dois te concentrer.	You have to concentrate.
voisin	n.neighbor	Mon voisin est devenu fou.	My neighbor has gone mad.
entièrement	adv.entirely	C'est entièrement de ta faute.	It is entirely your fault.
courrier	n.mail	Le courrier est arrivé.	The mail has arrived.
affronter	v.to confront	Vous devriez affronter la réalité.	You should face reality.
impressionnant	adj.impressive	C'est très impressionnant.	It is very impressive.
jaune	adj.yellow	Ne marchez pas dans la zone jaune.	Do not walk in the yellow zone.
bibliothèque	n.library	Ma maison est au nord de la bibliothèque.	My house is north of the library.
lentement	adv.slowly	Il marche très lentement.	He walks very slowly.
personnellement	adv.personally	Je ne le prends pas personnellement.	I do not take it personally.
étape	n.step	C'est le premier étape de mon plan.	It is the first step of my plan.
royaume	n.kingdom	Un royaume est dirigé par un roi ou une reine.	A kingdom is ruled by a king or queen.
courageux	adj.brave	Il est très courageux.	He is very brave.
maîtresse	n.mistress	Vous êtes la maîtresse.	You are the mistress.
bouffe	n.food	La bouffe est déjà sur la table.	The food is already on the table.
chanceux	adj.lucky	Un joueur chanceux gagnera tout l'argent.	A lucky player will win all of the money.
tasse	n.cup	Tu veux une tasse de thé ?	Do you want a cup of tea?
avouer	v.to admit	Il a avoué ne pas avoir dit la vérité.	He admitted that he had not told the truth.
soigner	v.to treat (an injury)	Le travail d'un médecin est de soigner les malades.	A doctor's job is to treat sick people.
aube	n.dawn	Le fermier se lève à l'aube pour nourrir les porcs.	The farmer gets up at dawn to feed the hogs.
miroir	n.mirror	Où trouver un miroir?	Where to find a mirror?
couvrir	v.to cover	Je vais te couvrir.	I'll cover you.
épreuve	n.test	L'étudiant a passé l'épreuve et a obtenu un bon résultat.	The student took the test and got a good result.
remplir	v.to fill	Il remplit la bouteille d'eau.	He fills the bottle with water.
égal	adj.equal	Les hommes et les femmes sont égaux devant la loi.	Men and women are equal before the law.
retenir	v.to hold back	Il te faut te retenir.	You have to hold back.
moto	n.motorcycle	Mon père m'a acheté une moto.	My father bought me a motorcycle.
annuler	v.to cancel	Devrions-nous annuler ?	Should we cancel?
séance	n.meeting	La séance finira dans quelques minutes.	The session will end in a few minutes.
valise	n.suitcase	Où est ta valise ?	Where's your suitcase?
cochon	n.pig	Le fermier élève des cochons.	The farmer raises pigs.
maudit	adj.damn	Aidez-moi à quitter cet endroit maudit.	Help me leave this cursed place.
poussière	n.dust	J'ai nettoyé la poussière du vieux livre.	I cleaned the dust off the old book.
printemps	n.spring	C'est le printemps que je préfère.	It is spring that I prefer.
interroger	v.to question	La police a interrogé le témoin.	The police questioned the witness.
briser	v.to break	Il a brisé la fenêtre en jouant au basket.	He broke the window playing basketball.
sauvage	adj.wild	Les ours sont des animaux sauvages.	Bears are wild animals.
